weekday	WEEKDAY
suite	Suite
camilyn_beth	Camilyn Beth
yumi	Yumi
harlyn	Harlyn
fancyfox	FANCYFOX
i.madeline	I.madeline
leanna_ford	Leanna Ford
dandy_digs	DANDY DIGS
bee_amour	Bee Amour
dooney_&_bourke	Dooney & Bourke
kuna	KUNA
stradivarius	Stradivarius
style_moi	Style Moi
mihano_momosa	Mihano Momosa
dsquared2	DSQUARED2
calzedonia	Calzedonia
incity	INCITY
la_mania	La Mania
dissh	Dissh
gigi_new_york	GiGi New York
park_lane_jewelry	Park Lane Jewelry
outnet	OUTNET
pacsun	PacSun
payless	Payless
people_tree	People Tree
piperlime	Piperlime
pologeorgis	pologeorgis
princess_polly	princess polly
river_island	River Island
revolve	REVOLVE
ron_herman	Ron Herman
ross	Ross
rue_la_la	Rue La La
saks_fifth_avenue	Saks Fifth Avenue
scoop_nyc	Scoop NYC
selfridges	Selfridges
shoemint	ShoeMint
shoegasm	Shoegasm
shop_hers	Shop Hers
shopbazaar	ShopBazaar
shopbop	Shopbop
shoplastyle	ShopLAStyle
shopplanetblue	shopplanetblue
shoptiques	Shoptiques
singer22	Singer22
solstice_sunglasses	Solstice Sunglasses
south_beach_swimsuits	South Beach Swimsuits
south_moon_under	South Moon Under
spoiledbrat	Spoiledbrat
ssense	SSENSE
st._bernard_sports	St. Bernard Sports
steven_alan	Steven Alan
stone_&_strand	Stone & Strand
stylebop	STYLEBOP
stylemint	StyleMint
sunglass_hut	Sunglass Hut
t.j.maxx	T.J.Maxx
the_fashion_bunker	The Fashion Bunker
the_iconic	THE ICONIC
the_shops_at_the_plaza	The Shops at The Plaza
thecorner	Thecorner
tobi	TOBI
topshop	Topshop
usc_fashion	USC Fashion
vente-privee	vente-privee
vault	VAULT
weddington_way	Weddington Way
wood_wood	WOOD WOOD
yayer	YAYER
yesstyle	YesStyle
yoox	YOOX
zappos	Zappos
myhabit	MyHabit
bershka	Bershka
goorin_brothers	Goorin Brothers
ca4la	CA4LA
kit_and_ace	Kit and Ace
hardt_jewelry	HARDT JEWELRY
ana_locking	Ana Locking
la_montréalaise_atelier	La Montréalaise atelier
rails	RAILS
the_frye_company	The Frye Company
mimi_hammer	Mimi Hammer
june_swimwear	June Swimwear
modern_vice	Modern Vice
coki_bijoux	Coki Bijoux
self-portrait	self-portrait
laudi_vidni	Laudi Vidni
comme_des_garcons	Comme des garcons
jacquemus	JACQUEMUS
vetements	VETEMENTS
allsaints	ALLSAINTS
kendra_scott	Kendra Scott
for_love_&_lemons	For Love & Lemons
show_me_your_mumu	Show Me Your Mumu
blue_life	Blue Life
swell	swell
public_school	Public School
tod's	Tod's
harpertrends	HarperTrends
mary_katrantzou	Mary Katrantzou
massimo_dutti	Massimo Dutti
matt_&_nat	matt & nat
matthew_williamson	Matthew Williamson
mavi	Mavi
max_mara	Max Mara
maurie_&_eve	Maurie & Eve
maxstudio.com	Maxstudio.com
mayle	Mayle
mcginn_collection	McGinn Collection
melissa	Melissa
me_&_zena	Me & Zena
melissa_masse_made_to_measure	Melissa Masse Made to Measure
mes_demoiselles_paris	Mes Demoiselles Paris
mi_pac	Mi Pac
michael_kors	Michael Kors
michael_simon	Michael Simon
michael_stars	Michael Stars
miguelina	Miguelina
mih_jeans	MiH Jeans
miista	Miista
mikoh_swimwear	Mikoh Swimwear
millesia	Millesia
milly_ny	Milly NY
mimi_holliday	Mimi Holliday
ming_wang	Ming Wang
mink_pink	MINK PINK
minnie_rose	Minnie Rose
miss_mandalay	Miss Mandalay
miraclebody_by_miraclesuit	MiracleBody by MiracleSuit
misook	Misook
miss_pom_pom	Miss Pom Pom
mission_control	Mission Control
modern_amusement	Modern Amusement
moncler	Moncler
monique_lhuillier	Monique Lhuillier
monki	Monki
monrow	MONROW
morgan_carper	Morgan Carper
morgane_le_fay	Morgane Le Fay
mother_denim	Mother Denim
moschino	MOSCHINO
mother_of_pearl	Mother of Pearl
mouillé	Mouillé
mr._gugu_&_miss_go	Mr. Gugu & Miss Go
msgm	MSGM
mulberry	MULBERRY
muubaa	Muubaa
my_line	MY LINE
myla_london	Myla London
naeem_khan	Naeem Khan
naf_naf	NAF NAF
nami	NAMI
nanushka	Nanushka
napapijri	Napapijri
nation_ltd	Nation LTD
native_rose	Native Rose
natori	Natori
nau	Nau
naven	Naven
neil_barrett	NEIL BARRETT
neon_buddha	Neon Buddha
new_balance	New Balance
new_era_cap	New Era Cap
nha_khanh	Nha Khanh
nic_+_zoe	Nic + Zoe
nicole_miller	Nicole Miller
nili_lotan	Nili Lotan
nina_ricci	NINA RICCI
nine_west	Nine West
nishe	NISHE
no._21	No. 21
nobody_denim	Nobody Denim
noisy_may	Noisy may
nonoo	Nonoo
nookie	NOOKIE
norma_kamali_collection	Norma Kamali Collection
notify	Notify
nsf	NSF
numari	NUMARI
nydj	NYDJ
oakley	Oakley
object_collectors_item	Object Collectors Item
oasis	Oasis
ohne_titel	Ohne Titel
oh_my_love	Oh My Love
omega	OMEGA
oliver_peoples_eyewear	Oliver Peoples Eyewear
olcay_gulsen	Olcay Gulsen
one_teaspoon	One Teaspoon
onepiece	OnePiece
ongossamer	OnGossamer
only	Only
only_hearts	Only Hearts
orelia	Orelia
organic_by_john_patrick	Organic by John Patrick
orion_london	Orion London
orla_kiely	Orla Kiely
oscar_de_la_renta	Oscar de la Renta
osman	Osman
ostwald_helgason	Ostwald Helgason
other_uk	Other UK
ottoman_hands	Ottoman Hands
paco_rabanne	Paco Rabanne
paige_denim	Paige Denim
pam_&_gela	Pam & Gela
pamella_roland	Pamella Roland
paper_crown	Paper Crown
panache	PANACHE
parker	Parker
parka_london	PARKA LONDON
passionata	Passionata
paul_&_joe	PAUL & JOE
paul's_boutique	Paul's Boutique
paule_ka	Paule Ka
pencey	Pencey
penfield	Penfield
pepe_jeans	PEPE JEANS
persol	Persol
peter_langner	Peter Langner
peter_jensen	PETER JENSEN
peter_pilotto	Peter Pilotto
peter_som	Peter Som
petit_bateau	Petit Bateau
phoebe_couture	Phoebe Couture
piaget	Piaget
piamita	Piamita
piazza_sempione	PIAZZA SEMPIONE
pieces	Pieces
piha_swimwear	Piha Swimwear
pink_tartan	PINK TARTAN
pinkyotto	Pinkyotto
pippa_lynn	Pippa Lynn
plastic_island	Plastic Island
pjk_patterson_j._kincaid	PJK Patterson J. Kincaid
playful_promises	Playful Promises
pleasure_doing_business	Pleasure Doing Business
pleasure_state	Pleasure State
plein_sud	Plein Sud
pleione	Pleione
poleci	Poleci
poorboy	Poorboy
porter_grey	Porter Grey
pop_boutique	Pop Boutique
ports_1961	Ports 1961
pour_moi	Pour Moi
prabal_gurung	Prabal Gurung
prana	prAna
preen_by_thornton_bregazzi	Preen By Thornton Bregazzi
pret_à_surf	Pret à Surf
prima_studio	PRIMA STUDIO
prince_peter	Prince Peter
princesse_tam.tam	Princesse tam.tam
pringle_of_scotland	Pringle of Scotland
proenza_schouler	Proenza Schouler
pronovias	Pronovias
puffa	Puffa
puma	PUMA
r13_denim	R13 Denim
rachel_comey	Rachel Comey
rachel_pally	Rachel Pally
rachel_roy	Rachel Roy
rachel_zoe	Rachel Zoe
radenroro	RADENRORO
rafael_cennamo	Rafael Cennamo
rag_&_bone	Rag & Bone
ragged_priest	Ragged Priest
rahul_mishra	RAHUL MISHRA
ralph_lauren	Ralph Lauren
ralph_rucci	Ralph Rucci
ramy_brook	Ramy Brook
ranna_gill	Ranna Gill
raoul	RAOUL
raquel_allegra	Raquel Allegra
ray-ban	Ray-Ban
rdm_by_rue_du_mail	RDM by Rue du Mail
reason	REASON
rebecca_minkoff	Rebecca Minkoff
red_carter	Red Carter
reem_acra	Reem Acra
reem_by_reem_alasadi	REEM by Reem Alasadi
reformation	Reformation
reiss	Reiss
religion_clothin	Religion Clothin
rena_lange	Rena Lange
renzo_+_kai	Renzo + Kai
revo	Revo
rich_&_skinny	Rich & Skinny
richard_chai	Richard Chai
rick_owens	Rick Owens
rickie_freeman's_teri_jon	Rickie Freeman's Teri Jon
riller_&_fount	Riller & Fount
robert_clergerie	Robert Clergerie
risto	Risto
robert_graham	Robert Graham
rock_'n_rose	ROCK 'N ROSE
rock_&_republic	Rock & Republic
rogan	Rogan
rodarte	Rodarte
roksanda_ilincic	Roksanda Ilincic
roland_mouret	Roland Mouret
romwe	Romwe
rory_beca	Rory Beca
roseanna	Roseanna
rvn	RVN
sachin_+_babi	Sachin + Babi
saint_grace	Saint Grace
sam_&_lavi	Sam & Lavi
sam_edelman	Sam Edelman
san_and_soni	San and Soni
sanctuary_clothing	Sanctuary Clothing
sandra_ingrish_&_co	Sandra Ingrish & Co
sandro	Sandro
santorelli	Santorelli
sauce	Sauce
sass_&_bide	sass & bide
scandale	Scandale
schott_bros._nyc	SCHOTT BROS. NYC
scotch_&_soda	Scotch & Soda
seafolly	Seafolly
selected	SELECTED
senso	Senso
serfontaine	Serfontaine
sergio_rossi	Sergio Rossi
sessun	Sessun
seventh_wonderland	Seventh Wonderland
shae	Shae
shakuhachi	Shakuhachi
shipley_&_halmos	Shipley & Halmos
shellys_london	Shellys London
shop_alexis	Shop Alexis
shopdame	ShopDAME
shoshanna	Shoshanna
shourouk	Shourouk
shona_joy	Shona Joy
shwood	Shwood
silver_spoon_attire	Silver Spoon Attire
sis_by_spijker_en_spijker	SIS BY SPIJKER EN SPIJKER
sister_jane	Sister Jane
siwy_denim	Siwy Denim
sky	Sky
skye_&_staghorn	SKYE & staghorn
sleep'n_round	Sleep'n Round
smith_optics	Smith Optics
smitten	Smitten
smythe	SMYTHE
soia_&_kyo	Soia & Kyo
sol_angeles	Sol Angeles
sol_sana	Sol Sana
solace_london	SOLACE LONDON
solow	SOLOW
sold_design_lab	SOLD Design Lab
somedays_lovin	Somedays Lovin
sonia_by_sonia_rykiel	Sonia by Sonia Rykiel
sonia_rykiel	Sonia Rykiel
sophia_kokosalaki	Sophia Kokosalaki
sophie_theallet	Sophie Theallet
sophiscat	Sophiscat
sorel	Sorel
sophomore	Sophomore
soybu	Soybu
spirithoods	Spirithoods
splendid	splendid
spring_&_clifton	Spring & Clifton
stance	STANCE
stefanel	Stefanel
steinunn	Steinunn
stella_&_jamie	Stella & Jamie
steve_madden	Steve Madden
stretta_moda	Stretta Moda
stylein	Stylein
stuart_weitzman	Stuart Weitzman
stylestalker	STYLESTALKER
suboo	Suboo
sue_wong	Sue Wong
sugarlips	Sugarlips
sundry	SUNDRY
sunhee	Sunhee
sunner	Sunner
suno	SUNO
sunseeker	Sunseeker
superdry	Superdry
superfine	Superfine
superga	Superga
supra	Supra
supremebeing	SUPREMEBEING
surf_bazaar	Surf Bazaar
surface_to_air	Surface to Air
susan_caplan	Susan Caplan
susana_monaco	susana monaco
sw3_bespoke	SW3 Bespoke
swarovski	SWAROVSKI
swatch	Swatch
swear	Swear
swedish_hasbeens	Swedish Hasbeens
swildens	Swildens
t_by_alexander_wang	T by Alexander Wang
tadashi_shoji	Tadashi Shoji
tag_heuer	TAG Heuer
talbot_runhof	Talbot Runhof
tallow	Tallow
talulah	Talulah
tankus	TANKUS
tara_jarmon	Tara Jarmon
tart_collections	Tart Collections
tatty_devine	Tatty Devine
taylor_dress	Taylor Dress
tbags_los_angeles	Tbags Los Angeles
ted_baker	Ted Baker
temperley_london	Temperley London
tempest	Tempest
tess_giberson	Tess Giberson
textile_federation	TEXTILE FEDERATION
tfnc	tfnc
thakoon	Thakoon
thayer	Thayer
the_addison_story	The Addison Story
the_arrivals	The Arrivals
the_earnest_sewn_co.	The Earnest Sewn Co.
the_lady_&_the_sailor	The Lady & The Sailor
the_lake_&_stars	The Lake & Stars
the_laundry_room	The Laundry Room
the_orvis	The Orvis
the_row	The Row
the_whitepepper	The WhitePepper
theia	Theia
theodora_&_callum	Theodora & Callum
theory	Theory
thomas_wylde	Thomas Wylde
thom_browne	Thom Browne
threadless	Threadless
threadsence	ThreadSence
three_dots	Three Dots
three_floor	Three Floor
tibi	Tibi
tiffany_&_co.	Tiffany & Co.
timberland	Timberland
timo_weiland	Timo Weiland
tocca	TOCCA
tinned_bananas	Tinned Bananas
tolani	Tolani
tommy_bahama	Tommy Bahama
tommy_hilfiger	Tommy Hilfiger
toms	TOMS
tomtom_jewelry	TomTom Jewelry
tori_praver	Tori Praver
torn_by_ronny_kobo	Torn by Ronny Kobo
torn_clothing	Torn Clothing
tory_burch	Tory Burch
tous	Tous
tracy_reese	Tracy Reese
tribune_standard	Tribune Standard
trina_turk	Trina Turk
tripp_nyc	Tripp NYC
true_decadence	True Decadence
trovata	Trovata
true_religion	True Religion
trussardi	Trussardi
truth_and_pride	Truth and Pride
tt_collection	Tt Collection
tucker_shop	Tucker Shop
tumi	Tumi
twelfth_street_by_cynthia_vincent	Twelfth Street by Cynthia Vincent
twenty_tees	Twenty Tees
twinkle_by_wenlan	Twinkle by Wenlan
twenty8twelve	Twenty8Twelve
tyler_rose_swimwear	Tyler Rose Swimwear
uintah	Uintah
ulla_johnson	Ulla Johnson
ultimo	Ultimo
under_armour	Under Armour
twobirds_bridesmaid	twobirds bridesmaid
underground_shoe	Underground Shoe
undrest	Undrest
united_colors_of_benetton	UNITED COLORS OF BENETTON
urstadt_swan	Urstadt Swan
vagabond_shoes	Vagabond Shoes
van_cleef_&_arpels	Van Cleef & Arpels
vanessa_bruno	Vanessa Bruno
vbn	VBN
veda	Veda
velvet_by_graham_&_spencer	Velvet by Graham & Spencer
vena_cava	Vena Cava
venni_caprice_clothing	Venni Caprice Clothing
vero_moda	VERO MODA
veronica_beard	Veronica Beard
vesper	Vesper
via_spiga	Via Spiga
victoria_beckham	Victoria Beckham
viktor&rolf	Viktor&Rolf
vila	VILA
vince_camuto	Vince Camuto
vince	Vince
vineyard_vines	Vineyard Vines
vintage_havana	Vintage Havana
virgos_lounge	Virgos Lounge
vivienne_tam	Vivienne Tam
vivienne_westwood	Vivienne Westwood
vix_swimwear	ViX Swimwear
vkoo	Vkoo
vogue_eyewear	Vogue Eyewear
von_follies_by_dita_von_teese	Von Follies by Dita Von Teese
voodoo_girl	Voodoo girl
vpl	VPL
w118_by_walter_baker	W118 By Walter Baker
wacoal	Wacoal
warby_parker	Warby Parker
warehouse	WAREHOUSE
we_are_handsome	We Are Handsome
wes_gordon	Wes Gordon
what_goes_around_comes	What Goes Around Comes
whetherly	Whetherly
whistles	Whistles
whit	Whit
white_house_|_black_market	White House | Black Market
white_+_warren	White + Warren
white_tent	White Tent
wildfox	Wildfox
william_rast	William Rast
willow	Willow
winter_kate	Winter Kate
wkshp	WkShP
wolford	Wolford
wish_xoxo	Wish xoxo
won_hundred	Won Hundred
worn_by	Worn By
wren	wren
wrangler	Wrangler
y-3	Y-3
y.a.s	Y.A.S
yigal_azrouël	Yigal Azrouël
you_must_create	You Must Create
yoana_baraschi	Yoana Baraschi
xcvi_fashion	XCVI Fashion
yohji_yamamoto	Yohji Yamamoto
young_fabulous_&_broke	Young Fabulous & Broke
youreyeslie	YourEyesLie
yumi_kim	Yumi Kim
yummie_tummie	Yummie Tummie
yves_saint_laurent	Yves Saint Laurent
zac_posen	Zac Posen
zadig_&_voltaire	Zadig & Voltaire
zales	Zales
zero_+_maria_cornejo	Zero + Maria Cornejo
zephyr	Zephyr
zimmermann	Zimmermann
zinke	Zinke
zoa	Zoa
zobha	Zobha
zoe_&_morgan	Zoe & Morgan
zoe_jordan	Zoe Jordan
zoe_karssen	Zoe Karssen
abercrombie_&_fitch	Abercrombie & Fitch
adidas	adidas
aéropostale	Aéropostale
aerosoles	Aerosoles
american_apparel	American Apparel
american_eagle_outfitters	American Eagle Outfitters
ann_taylor	Ann Taylor
athleta	Athleta
banana_republic	Banana Republic
barami	Barami
baublebar	BaubleBar
bebe	bebe
billionaire_boys_club_ice_cream	Billionaire Boys Club Ice Cream
boohoo	Boohoo
c._wonder	C. Wonder
charlotte_russe	Charlotte Russe
chico's	Chico's
columbia	Columbia
converse	Converse
crocs	Crocs
daisy_street	Daisy Street
daisystreet	daisystreet
desigual	Desigual
ecugo_street_fashion_sketch	Ecugo Street Fashion Sketch
eddie_bauer	Eddie Bauer
edwin	Edwin
express	Express
forever_21	Forever 21
gant	GANT
gilly_hicks	Gilly Hicks
gaiam	Gaiam
goliath_sportswear	Goliath Sportswear
gu	GU
guess	GUESS
h&m	H&M
hollister_co.	Hollister Co.
j.crew	J.Crew
joe_fresh	Joe Fresh
l.l.bean	L.L.Bean
gap	Gap
lacoste	Lacoste
levi's	Levi's
lf_stores	LF Stores
mika_yoga_wear	Mika Yoga Wear
miss_selfridge	Miss Selfridge
missguided	Missguided
monsoon	MONSOON
nautica	Nautica
nike	Nike
north_face	North Face
oasap	Oasap
old_navy	Old Navy
persun	Persun
primark	Primark
quiksilver	Quiksilver
reebok	Reebok
rue21	Rue21
select_fashion	Select Fashion
she_insider	She insider
spanx	SPANX
talbots	TALBOTS
udobuy	Udobuy
uniqlo	UNIQLO
urban_outfitters	Urban Outfitters
vans	Vans
victoria's_secret	Victoria's Secret
wet_seal	Wet Seal
zara	ZARA
15love	15love
a._lange_&_söhne	A. Lange & Söhne
agent_provocateur	Agent Provocateur
akris	Akris
alberta_ferretti	ALBERTA FERRETTI
andrew_marc	Andrew Marc
anne_fontaine	Anne Fontaine
annie_fensterstock	Annie Fensterstock
armani	ARMANI
armani_exchange	Armani Exchange
armenta	Armenta
armin_strom	ARMIN STROM
audemars_piguet	Audemars Piguet
balenciaga	BALENCIAGA
barbara_bui	Barbara Bui
blanc_de_chine	Blanc de Chine
bally	Bally
bottega_veneta	Bottega Veneta
brunello_cucinelli	Brunello Cucinelli
breguet	Breguet
bulgari	Bulgari
burberry	Burberry
cartier	Cartier
céline	CÉLINE
chanel	Chanel
christian_louboutin	Christian Louboutin
cushnie_et_ochs	CUSHNIE ET OCHS
de_beers	De Beers
dior	Dior
dvf	DVF
edun	EDUN
emilio_pucci	Emilio Pucci
etro	ETRO
fendi	Fendi
givenchy	Givenchy
gucci	Gucci
h.stern	H.Stern
harry_winston	Harry Winston
hermès	Hermès
herve_leger	Herve Leger
hugo_boss	Hugo Boss
jil_sander	Jil Sander
jimmy_choo	JIMMY CHOO
kenzo	KENZO
lancel	Lancel
lanvin	LANVIN
loewe	Loewe
longchamp	Longchamp
loro_piana	Loro Piana
louis_vuitton	Louis Vuitton
mansur_gavriel	Mansur Gavriel
mikimoto	MIKIMOTO
miu_miu	Miu Miu
patek_philippe	Patek Philippe
paul_&_shark	Paul & Shark
paul_smith	Paul Smith
philipp_plein	Philipp Plein
porsche_design	Porsche Design
prada	Prada
reed_krakoff	Reed Krakoff
roberto_cavalli	Roberto Cavalli
rolex	ROLEX
rupert_sanderson_london	Rupert Sanderson London
salvatore_ferragamo	Salvatore Ferragamo
st._john	St. John
stella_mccartney	Stella McCartney
thomas_pink	Thomas Pink
valentino	Valentino
vera_wang	Vera Wang
versace	Versace
vionnet	Vionnet
15dollarstore	15Dollarstore
6pm	6pm
80spurple	80spurple
a_pea_in_the_pod	A Pea in the Pod
akira_chicago	AKIRA Chicago
anthropologie	Anthropologie
american_rag_cie	American Rag Cie
ark_clothing	Ark Clothing
aritzia	ARITZIA
asianicandy	Asianicandy
avenue_32	Avenue 32
azaleas_in_nyc	Azaleas in NYC
bank_fashion	BANK Fashion
barneys_new_york	Barneys New York
beams	BEAMS
bergdorf_goodman	Bergdorf Goodman
beso	beso
big_drop_nyc	Big Drop NYC
bird	Bird
bleu_clothing	Bleu Clothing
bloomingdale's	Bloomingdale's
blue_heaven_boutique	Blue Heaven Boutique
bluefly	Bluefly
boticca	Boticca
boutique_to_you	Boutique To You
brownsfashion	brownsfashion
burlington	Burlington
bylangley	ByLangley
asos	ASOS
choies	Choies
couturecandy	CoutureCandy
conleys	Conleys
cusp_by_neiman_marcus	Cusp by Neiman Marcus
dailylook	DailyLook
debenhams	Debenhams
derriere_de_soie	Derriere de Soie
dillard's	Dillard's
ditto	DITTO
dorothy_perkins	Dorothy Perkins
dressed_by_fifi	Dressed by fifi
dressspace	DRESSSPACE
edge_clothing	edge clothing
dune_london	Dune London
fabricly	Fabricly
faire_frou_frou	Faire Frou Frou
farfetch	Farfetch
forzieri	Forzieri
forward_by_elyse_walker	Forward by Elyse Walker
free_people	Free People
geren_ford	Geren Ford
gilt	Gilt
frock_fashions	Frock Fashions
glamorous	Glamorous
goodnight_macaroon	Goodnight Macaroon
harrods	Harrods
harvey_nichols	Harvey Nichols
hautelook	HauteLook
holt_renfrew	Holt Renfrew
house_of_fraser	house of fraser
ideeli	ideeli
inlovewithfashion	Inlovewithfashion
intermix	INTERMIX
intimint	IntiMINT
jcpenney	JCPenney
jewelmint	JewelMint
john_lewis	John Lewis
joseph_fashion	Joseph Fashion
journelle	Journelle
kirna_zabete	Kirna Zabete
kitson_la	Kitson LA
kurt_geiger	Kurt Geiger
lane_crawford	Lane Crawford
largo_drive	Largo Drive
les_nouvelles	Les Nouvelles
lord_&_taylor	Lord & Taylor
le_bon_marché_rive_gauche	Le Bon Marché Rive Gauche
lipsy	Lipsy
luisa_via_roma	Luisa Via Roma
loveclothing	LoveClothing
lulus	Lulus
macy's	Macy's
madison_los_angeles	Madison Los Angeles
marbella_clothing	Marbella Clothing
market_hq	Market HQ
matchesfashion	Matchesfashion
meemee	MeeMee
mendocino_clothing	Mendocino Clothing
merrin_and_gussy	Merrin and Gussy
mikkat_market	Mikkat Market
missesdressy	Missesdressy
misskl	MissKL
moda_operandi	Moda Operandi
modcloth	ModCloth
motel_rocks	Motel Rocks
my_wardrobe	My wardrobe
mytheresa	mytheresa
nasty_gal	Nasty Gal
necessaryclothing	Necessaryclothing
need_supply_co.	Need Supply Co.
neiman_marcus	Neiman Marcus
nelly	Nelly
net-a-porter	NET-A-PORTER
new_look	New Look
next	Next
nordstrom	Nordstrom
oliver	Oliver
opening_ceremony	Opening Ceremony
originalnative	OriginalNative
:chocoolate	:Chocoolate
291_venice	291 Venice
3.1_phillip_lim	3.1 Phillip Lim
3x1	3x1
47_brand	47 Brand
4.collective	4.collective
49_square_miles	49 Square Miles
525_america	525 America
360sweater	360Sweater
55dsl	55DSL
6397	6397
6_shore_road	6 Shore Road
66north	66North
7_for_all_mankind	7 For All Mankind
71_stanton	71 Stanton
9seed	9seed
a_&_r_cashmere	a & R Cashmere
a_bathing_ape	A BATHING APE
a_fine_line	A Fine Line
a_question_of	A QUESTION OF
a_wear	A wear
a.f.vandevorst	A.F.VANDEVORST
a.j._morgan_eyewear	A.J. Morgan Eyewear
a.l.c.	A.L.C.
a.p.c.	A.P.C.
abi_ferrin	Abi Ferrin
abs_by_allen_schwartz	ABS by Allen Schwartz
ace_&_jig	ace & jig
acne_studios	Acne Studios
adam_lippes	Adam Lippes
adolfo_dominguez	ADOLFO DOMINGUEZ
adrianna_papell	Adrianna Papell
adrienne_landau	Adrienne Landau
adrienne_vittadini	Adrienne Vittadini
aerin	AERIN
aesa	AESA
ag_jeans	AG Jeans
agnès_b.	agnès b.
again_los_angeles	Again Los Angeles
aiayu	AIAYU
aidan_mattox	Aidan Mattox
aijek	Aijek
aiko	AIKO
akiko_clothing	Akiko Clothing
alberto_makali	Alberto Makali
alder_new_york	Alder New York
aldo	ALDO
alessandra_rich	ALESSANDRA RICH
alex_evenings	Alex Evenings
alexander_wang	Alexander Wang
alexandre_birman	Alexandre Birman
alexandre_herchcovitch	Alexandre Herchcovitch
alexia_admor	Alexia Admor
alexis_bittar	Alexis Bittar
alexis_mabille	Alexis Mabille
ali_ro	Ali Ro
alice_&_trixie	Alice & Trixie
alice_+_olivia	alice + olivia
all_about_eve	ALL ABOUT EVE
allison_parris	Allison Parris
alpha_industries	Alpha Industries
altuzarra	ALTUZARRA
amanda_uprichard	Amanda Uprichard
ambikaboutique	Ambikaboutique
american_retro	American Retro
american_vintage	American Vintage
aminaka_wilmont	Aminaka Wilmont
amore_&_sorvete	Amore & Sorvete
amsale	Amsale
amy_matto_new_york	Amy Matto New York
ancient_greek_sandals	Ancient Greek Sandals
and	And
andré_courrèges	André Courrèges
andrea_fohrman	Andrea Fohrman
andres_sarda	Andres Sarda
andrew_gn	ANDREW GN
andy_lifschutz	Andy Lifschutz
angel_sanchez	Angel Sanchez
anita_ko	Anita Ko
alison_lou	Alison Lou
anjelika_dreams_organic	anjelika dreams organic
ann_demeulemeester	Ann Demeulemeester
ann_dexter-jones	Ann Dexter-Jones
amedeo	Amedeo
anna_&_boy	Anna & Boy
ann-sofie_back	Ann-Sofie Back
anna_karin_karlsson	Anna Karin Karlsson
anna_sui	Anna Sui
anndra_neen	Anndra Neen
annette_ferdinandsen	Annette Ferdinandsen
anthony_vaccarello	ANTHONY VACCARELLO
anine_bing	ANINE BING
antipodium	Antipodium
antonio_berardi	Antonio Berardi
anya_hindmarch	ANYA HINDMARCH
apiece_apart	Apiece Apart
antik_batik	Antik Batik
aq_aq	AQ AQ
aquascutum	Aquascutum
aquazzura	AQUAZZURA
aquilano_rimondi	Aquilano Rimondi
araks	ARAKS
armand_diradourian_cashmere	Armand Diradourian Cashmere
arme_de_l'amour	Arme De L'Amour
armor_lux	Armor Lux
arnette	Arnette
arnhem_clothing_byron_bay	Arnhem Clothing Byron Bay
arrogant_cat	Arrogant Cat
artfit	Artfit
arunashi	Arunashi
ashley_b	Ashley B
ashley_pittman	Ashley Pittman
atelier_erik_hart	Atelier Erik Hart
april,_may	April, May
aurélie_bidermann	Aurélie Bidermann
ash	Ash
awwdore	Awwdore
autumn_cashmere	Autumn Cashmere
ash_rain_+_oak	Ash Rain + Oak
ax_paris	Ax Paris
azzaro	Azzaro
ba&sh	ba&sh
back_label	BACK LABEL
bailey_44	Bailey 44
badgley_mischka	Badgley Mischka
baldwin_denim	Baldwin Denim
balmain	Balmain
band_of_gypsies	Band of Gypsies
band_of_outsiders	Band of Outsiders
banjo_&_matilda	Banjo & Matilda
barbour	Barbour
base_range	BASE range
baum_und_pferdgarten	Baum und Pferdgarten
bb_dakota	BB Dakota
baku_swimwear	Baku Swimwear
bec_and_bridge	Bec and Bridge
behnaz_sarafpour	Behnaz Sarafpour
bella_freud	Bella Freud
bellaluxx	Bellaluxx
bellatrix	Bellatrix
belle_&_bunty	Belle & Bunty
bellfield	Bellfield
bellville_sassoon	Bellville Sassoon
belstaff	Belstaff
ben_amun	Ben Amun
berek	Berek
bernardo	Bernardo
bertie_shoes	Bertie Shoes
betsey_johnson	Betsey Johnson
betsy_&_adam	Betsy & Adam
bettinis	Bettinis
beulah_london	Beulah London
beyond_vintage	Beyond Vintage
bibhu_mohapatra	Bibhu Mohapatra
big_star	Big Star
bill_blass	Bill Blass
bionda_castana	Bionda Castana
birkenstock	Birkenstock
biyan	BIYAN
björn_borg	Björn Borg
black_halo	Black Halo
black_orchid_denim	Black Orchid Denim
blank_jeans	BLANK JEANS
blaque_label	Blaque Label
bless'ed_are_the_meek	Bless'ed Are The Meek
blink_shoes	Blink Shoes
blk_dnm	BLK DNM
bluebella_fabulous	Bluebella Fabulous
blugirl	Blugirl
blumarine	BLUMARINE
bodas	Bodas
boden	Boden
borders_&_frontiers	BORDERS & FRONTIERS
botticelli	Botticelli
bp_studio	BP Studio
boy_london	BOY London
brashy_couture	Brashy Couture
braza	Braza
brian_atwood	Brian Atwood
brian_lichtenberg	BRIAN LICHTENBERG
bronx_shoes	BRONX SHOES
brooke_gregson	Brooke Gregson
brooks_brothers	Brooks Brothers
bruno_magli	Bruno Magli
bruuns_bazaar	Bruuns Bazaar
bulova	Bulova
burning_torch	Burning Torch
by_caprice	By Caprice
by_malene_birger	By Malene Birger
c&c_california	C&C California
caché	Caché
calvin_klein	Calvin Klein
calypso_st._barth	Calypso St. Barth
cambridge_satchel	CAMBRIDGE SATCHEL
cameo_the_label	Cameo The Label
camilla_and_marc	Camilla and Marc
camper	Camper
canada_goose	Canada Goose
candela	Candela
cardigan_by_lynne_hiriak	Cardigan by Lynne Hiriak
carine_gilson_lingerie_couture	Carine Gilson Lingerie Couture
carlos_miele	Carlos Miele
carmen_marc_valvo	Carmen Marc Valvo
carole_hochman	Carole Hochman
carolina_bucci	Carolina Bucci
carolina_herrera	Carolina Herrera
carolina_k	Carolina K
carrie_parry	Carrie Parry
carvela_by_spitz	Carvela by Spitz
caroline_devillo_couture	Caroline DeVillo Couture
carven	Carven
casadei	Casadei
catherine_deane	Catherine Deane
catherine_malandrino	Catherine Malandrino
cecil_mcbee	CECIL McBEE
cédric_charlier	Cédric Charlier
central_park_west	Central Park West
chaiken	Chaiken
charles_henry	Charles Henry
charlie_by_matthew_zink	Charlie by Matthew Zink
charlie_jade	Charlie Jade
charlotte_ronson	Charlotte Ronson
chaser	Chaser
chaus	Chaus
chicnova	Chicnova
cheap_monday	Cheap Monday
chinti_and_parker	Chinti and Parker
chicwish	Chicwish
christian_lacroix	Christian Lacroix
christian_cota	Christian Cota
chloé	Chloé
christian_siriano	Christian Siriano
christopher_blue	Christopher Blue
christopher_raeburn	Christopher Raeburn
cinzia_rocca	Cinzia Rocca
citizens_of_humanity	Citizens of Humanity
citron	Citron
cj_by_cookie_johnson	Cj by Cookie Johnson
closet_clothing	Closet Clothing
clover_canyon	Clover Canyon
clu	Clu
club_monaco	CLUB MONACO
coach	Coach
coast	Coast
cole_haan	Cole Haan
collective_concepts	Collective Concepts
collette_dinnigan	Collette Dinnigan
common_projects	Common Projects
comptoir_des_cotonniers	Comptoir des Cotonniers
corey_lynn_calter	Corey Lynn Calter
cooper_&_ella	Cooper & Ella
cos	cos
costello_tagliapietra	COSTELLO TAGLIAPIETRA
costume_national	CoSTUME NATIONAL
criminal_damage	Criminal Damage
crop_by_david_peck	Crop by David Peck
cue	Cue
current_elliott	CURRENT ELLIOTT
cutler_and_gross	Cutler and Gross
cyberjammies	Cyberjammies
cynthia_rowley	Cynthia Rowley
dalia_macphee	Dalia MacPhee
cynthia_steffe	Cynthia Steffe
dana-maxx	Dana-Maxx
daniel_vosovic	Daniel Vosovic
daryl_k_|_kerrigan	Daryl K | Kerrigan
david_koma	DAVID KOMA
david_meister	David Meister
dawn_levy	Dawn Levy
day_birger_et_mikkelsen	Day Birger et Mikkelsen
denham_the_jeanmaker	DENHAM The Jeanmaker
dennis_basso	Dennis Basso
design_history	Design History
derek_lam	Derek Lam
diesel	Diesel
dion_lee	DION LEE
dirk_bikkembergs	DIRK BIKKEMBERGS
dkny	DKNY
dl1961	DL1961
dolan	dolan
domenico_vacca	Domenico Vacca
dolce_vita	Dolce Vita
donna_mizani	Donna Mizani
donna_morgan	Donna Morgan
doo.ri	Doo.Ri
doucette_duvall	Doucette Duvall
dr._denim_jeansmakers	Dr. Denim Jeansmakers
dr._martens	Dr. Martens
dstld	DSTLD
duffy_nyc	DUFFY NYC
dylan_george	Dylan George
each_other	EACH OTHER
e_l_l_e_r_y	E L L E R Y
eastpak	EASTPAK
edith_a_miller	Edith A Miller
ef_collection	EF COLLECTION
eileen_fisher	Eileen Fisher
eleven_paris	Eleven Paris
elie_saab	Elie Saab
elise_ryan	Elise Ryan
elie_tahari	Elie Tahari
eliza_j_ny	Eliza J NY
ella_moss	Ella Moss
elizabeth_and_james	Elizabeth and James
ellesse	ellesse
emanuel_ungaro	Emanuel Ungaro
emilio_cavallini	Emilio Cavallini
emmajane_-_label	Emmajane - Label
enza_costa	Enza Costa
erdem	Erdem
equipment	Equipment
erin_fetherston	Erin Fetherston
eryn_brinié	eryn brinié
escada	ESCADA
eskell	Eskell
essentiel	Essentiel
esprit	Esprit
eva_franco	Eva Franco
etienne_marcel	Etienne Marcel
ever/after	ever/after
evil_twin	EVIL TWIN
evisu	EVISU
evollove	Evollove
f-troupe	F-Troupe
faconnable	Faconnable
fashion_forms	Fashion Forms
faith_connexion	Faith Connexion
filippa_k	Filippa K
fidelity_denim	Fidelity Denim
finchittida_finch	Finchittida Finch
finders_keepers	Finders Keepers
fiorelli	FIORELLI
fjällräven	Fjällräven
flat_fitty	Flat Fitty
fleur_du_mal	Fleur du Mal
fleur_of_england	Fleur Of England
fluxus_brand	Fluxus Brand
flynn_skye_by_amber_farr	Flynn Skye by Amber Farr
foley_+_corinna	Foley + Corinna
forever_unique	Forever Unique
fossil	Fossil
frame_denim	FRAME Denim
francis_leon	Francis Leon
frankie_b.	Frankie B.
freak_of_nature	Freak of Nature
fred_perry	Fred Perry
free_city	FREE CITY
french_connection	French Connection
freya	Freya
friend_of_mine	Friend of Mine
friends_&_associates	Friends & Associates
frock_and_frill	Frock and Frill
funky_bling	FUNKY BLING
g-star_raw	G-Star Raw
ganni	Ganni
gareth_pugh	Gareth Pugh
generation_love	Generation Love
gary_graham	Gary Graham
gerard_darel	Gerard darel
genetic	Genetic
giambattista_valli	Giambattista Valli
gianvito_rossi	Gianvito Rossi
ginger_fizz	Ginger Fizz
giulietta	Giulietta
giuseppe_zanotti	Giuseppe Zanotti
gola	Gola
gold_hawk_clothing	Gold Hawk Clothing
goldsign_jeans	Goldsign Jeans
gossard	Gossard
grayse	Grayse
greylin	Greylin
gryphon_new_york	Gryphon New York
gypsy_05	Gypsy 05
h.naoto	h.NAOTO
habitual	Habitual
haider_ackermann	Haider Ackermann
hale_bob	Hale Bob
halston	Halston
happiness	happiness
happy_socks	Happy Socks
hard_tail	Hard Tail
hatch_collection	Hatch Collection
haus_alkire	Haus Alkire
haute_hippie	Haute Hippie
head	HEAD
hayley_paige	Hayley Paige
heavy_eco	Heavy Eco
heidi_klein	heidi klein
heidi_merrick	Heidi Merrick
heidi_weisel	Heidi Weisel
helen_kaminski_usa	Helen Kaminski USA
helly_hansen	Helly Hansen
helmut_lang	HELMUT LANG
henri_bendel	Henri Bendel
hide	HIDE
high	HIGH
hisui	HISUI
hobbs	Hobbs
house_of_hackney	HOUSE OF HACKNEY
houseofmai	HouseOfMai
hudson_jeans	Hudson Jeans
hue	HUE
huit_8	Huit 8
hunter_bell	Hunter Bell
hussein_chalayan	HUSSEIN CHALAYAN
hybrid_fashion	Hybrid Fashion
hussein_chalayan	Hussein Chalayan
hyden_yoo	Hyden Yoo
hype	HYPE
hysteric_glamour	HYSTERIC GLAMOUR
i_love_aquarius	I Love Aquarius
ianywear	iAnyWear
ichiban_clothing	Ichiban Clothing
illustrated_people	Illustrated People
imitation	Imitation
implicite	IMPLICITE
ines_di_santo	Ines di Santo
indah	Indah
inhabit	INHABIT
iro	IRO
isaac_mizrahi	Isaac Mizrahi
isabel_lu	Isabel Lu
isabel_marant	ISABEL MARANT
issey_miyake	Issey Miyake
issa	Issa
ivy_&_blu	Ivy & Blu
j_brand	J BRAND
j._mendel	J. Mendel
j.lindeberg	J.Lindeberg
jachs	JACHS
j.w.anderson	J.W.ANDERSON
jack_wills	Jack Wills
jadetribe	JADEtribe
jaeger	Jaeger
jag_jeans	Jag Jeans
james_jeans	James Jeans
jarlo	JARLO
jas_mb	Jas MB
jason_wu	Jason Wu
jay_godfrey	Jay Godfrey
jean_shop_nyc	Jean Shop NYC
jeffrey_monteiro	Jeffrey Monteiro
jen's_pirate_booty	Jen's Pirate Booty
jenni_kayne	Jenni Kayne
jenny_packham	Jenny Packham
jigsaw	Jigsaw
joe's_jeans	Joe's Jeans
john_zack	John Zack
johnny_was_clothing	Johnny Was Clothing
johnny_loves_rosie	Johnny Loves Rosie
jill_stuart	Jill Stuart
johnstons_of_elgin	Johnstons of Elgin
joie	Joie
jonathan_aston_hosiery	Jonathan Aston Hosiery
jonathan_saunders	Jonathan Saunders
jonathan_simkhai	JONATHAN SIMKHAI
jones_&_jones	Jones & Jones
jones_new_york	Jones New York
josa_tulum	JOSA tulum
josh_goot	Josh Goot
josie_by_natori	Josie By Natori
joyrich	Joyrich
js_collections	JS Collections
juicy_couture	Juicy Couture
julie_haus	Julie Haus
juliet_dunn	Juliet Dunn
juliette_longuet	Juliette Longuet
juma	JUMA
just_cavalli	Just Cavalli
just_female	Just Female
kaelen	Kaelen
kai-aakmann	Kai-aakmann
kain_label	Kain Label
kamalikulture	KAMALIKULTURE
karen_kane	Karen Kane
karen_millen	Karen Millen
karen_zambos_vintage_couture	Karen Zambos Vintage Couture
karl_lagerfeld	Karl Lagerfeld
karolina_zmarlak	Karolina Zmarlak
kas_newyork	KAS Newyork
kate_spade_new_york	Kate Spade New York
kaufmanfranco	KAUFMANFRANCO
kay_unger_new_york	Kay Unger New York
keepsake_the_label	Keepsake The Label
kelly_wearstler,_inc.	Kelly Wearstler, Inc.
kenneth_cole	Kenneth Cole
kenny	Kenny
kestenbaum_&_weisner	Kestenbaum & Weisner
kiki_de_montparnasse	Kiki de Montparnasse
kiks_tyo	KIKS TYO
kimberly_ovitz	Kimberly Ovitz
joan_vass	Joan Vass
komarov_clothing	Komarov Clothing
kookai	Kookai
kooples	Kooples
koral	Koral
kova_&_t	Kova & T
ksubi	ksubi
kule	KULE
kushcush_by_kerry_cushman	Kushcush by Kerry Cushman
kut_from_the_kloth	KUT from the Kloth
l.a.m.b.	L.A.M.B.
l.k.bennett	L.K.Bennett
l'atelier_fashion_uk	L'Atelier Fashion UK
la_belle_rebelle	La Belle Rebelle
la_fée_verte	La Fée Verte
la_femme_fashion	La Femme Fashion
la_perla	La Perla
label+thread	LABEL+thread
label_by_five_twelve	LABEL by five twelve
la_petite_robe_di_chiara_boni	La Petite Robe di Chiara Boni
lafayette_148_new_york	Lafayette 148 New York
laird_london	Laird London
lascivious	LASCIVIOUS
lashes_of_london	Lashes Of London
laugh_cry_repeat	Laugh Cry Repeat
lauren_b	Lauren B
laundry_by_shelli_segal	Laundry by Shelli Segal
lauren_moffatt	Lauren Moffatt
laura_lee_jewellery	Laura Lee Jewellery
laveer	LAVEER
lavish_alice	Lavish Alice
lazy_oaf	Lazy Oaf
le_mystere	Le Mystere
le66	Le66
lela_rose	Lela Rose
lemlem	Lemlem
lepel	Lepel
leroy_&_perry	LEROY & PERRY
les_prairies_de_paris	Les Prairies de Paris
letarte_swimwear	Letarte Swimwear
level_99_denim	Level 99 Denim
libertine-libertine	Libertine-Libertine
leyendecker_los_angeles	Leyendecker Los Angeles
lilly_pulitzer	lilly pulitzer
limi_feu	LIMI feu
line_&_dot	Line & Dot
line_knitwear	LINE Knitwear
lipstick_boutique	Lipstick Boutique
lisa_curran_swim	Lisa Curran Swim
lily_lotus	Lily Lotus
lisa_maree	Lisa Maree
lisa_perry	Lisa Perry
little_mistress	Little Mistress
little_white_lies	Little White Lies
liverpool_jeans_company	Liverpool Jeans Company
lna	LNA
local_heroes	Local Heroes
loft	LOFT
lolli_swim	Lolli Swim
lolly	Lolly
loomstate	Loomstate
london_fog	London Fog
lorick	Lorick
lot78	Lot78
lou	Lou
louise_amstrup	Louise Amstrup
love_culture	Love Culture
love_zooey	Love Zooey
lovers_+_friends	Lovers + Friends
lover	LOVER
lrk_collection	LRK Collection
lucca_couture	Lucca Couture
lucky_brand	Lucky Brand
lucy	lucy
lululemon_athletica	lululemon athletica
lutz_&_patmos	Lutz & Patmos
lyn_devon	Lyn Devon
m.patmos	M.Patmos
maaji	Maaji
mackage	Mackage
made	Made
madeleine_thompson	Madeleine Thompson
madewell	Madewell
madison_marcus	Madison Marcus
magaschoni	Magaschoni
maggy_london	Maggy London
maidenform	Maidenform
maison_martin_margiela	Maison Martin Margiela
maje	Maje
majestic_athletic	Majestic Athletic
malia_mills	Malia Mills
malo	Malo
mamalicious	mamalicious
mango	Mango
mara_hoffman	Mara Hoffman
marc_bouwer	Marc Bouwer
marchesa	Marchesa
marcobologna	Marcobologna
marena_y_sol	Marena Y Sol
maria_francesca_pepe	MARIA FRANCESCA PEPE
maria_grachvogel	Maria Grachvogel
marie_meili	MARIE MEILI
marimekko	MARIMEKKO
marios_schwab	Marios Schwab
markus_lupfer	Markus Lupfer
marlies_dekkers	marlies dekkers
marni	Marni
mason_by_michelle_mason	Mason by Michelle Mason
red_valentino	RED Valentino
see_by_chloé	See by Chloé
dolce_&_gabbana	Dolce & Gabbana
donna_karan_new_york	Donna Karan New York
nanette_lepore	Nanette Lepore
tom_ford	TOM FORD
missoni	Missoni
rebecca_taylor	Rebecca Taylor
robert_rodriguez	Robert Rodriguez
alexander_mcqueen	Alexander McQueen
marc_jacobs	Marc Jacobs
bcbgmaxazria	BCBGMAXAZRIA
cut25_by_yigal_azrouël	Cut25 by Yigal Azrouël
jean_paul_gaultier	Jean Paul Gaultier
